{
  "h1": "30",
  "h2": "50",
  "h3": "70",
  "h4": "90",
  "h5": "110",
  "h6": "130"
}